#######B 
##     # 
## ##### 
A  ##### 
#  ##### 
#    ### 
####     